map_start
00 00 00 00 10 10 10 10 10 00 00 00 00
00 00 00 10 10 10 10 10 10 10 00 00 00
00 00 10 10 10 10 10 10 10 10 10 00 00
00 10 10 10 10 10 10 10 10 10 10 10 00
10 10 10 10 10 10 10 10 10 10 10 10 10
10 10 10 10 10 10 10 10 10 10 10 10 10
10 10 10 10 10 10 10 10 10 10 10 1I 10
10 10 10 10 10 10 10 10 10 10 10 10 10
00 00 00 00 00 00 5A 00 00 00 00 00 00
map_end
initpos=I
locations_start
A=town
locations_end
